#######################################################
#######################################################
##G#           #         #                       #   ##
## # ######### # ##### # ##### ################# # # ##
## #   # #     # #     #       #   #         # # # # ##
## ### # # ####### ############# ### ##### # # # # # ##
##     # #       # #     #   #       #     #   # # # ##
######## ####### # # ### # # ### ##### ####### # ### ##
##       #       #     #   #   #   #   #   #   #   # ##
## ####### ################### ##### ### ### ##### # ##
##         #   #       #       #     #   #   #     # ##
## ######### # # # ### # ####### ##### ### ### ##### ##
##       #   # # # #   # #   #   #     #     # #   # ##
######## ### # # # # ### # ### # ##### # ##### # # # ##
## #   #     # # # #     # #   # #   #   # #   # #   ##
## # # ####### ### ####### # ### # # # ### # ### ### ##
##   #       #   # #         # #   # #     # #   # # ##
## ####### ##### # # ######### ##### ##### # # ### # ##
## #     # #   # # #         #   #   #   # # #   # # ##
## # ### # # # # # ######### ### # ### # ### ### # # ##
##   #   #   #     #             #     #         #  S##
#######################################################
#######################################################